# lvlwidth 21
# lvlheight 25
# bgcolor 0 0 0
# edgecolour 0 0 255
# fillcolour 0 0 0
# pelletcolour 255 255 255
# fruittype 1

# startleveldata
000 000 000 000 000 000 000 000 000 113 021 113 000 000 000 000 000 000 000 000 000
000 107 100 100 100 100 100 100 100 106 000 105 100 100 100 100 100 100 100 108 000
000 101 002 002 002 002 002 002 002 002 002 002 002 002 002 002 002 002 002 101 000
000 101 003 120 002 113 002 111 100 108 002 107 100 112 002 113 002 120 003 101 000
000 101 002 002 002 101 002 002 002 101 002 101 002 002 002 101 002 002 002 101 000
000 101 002 111 100 106 002 113 002 110 002 110 002 113 002 105 100 112 002 101 000
000 101 002 002 002 002 002 101 002 002 002 002 002 101 002 002 002 002 002 101 000
000 101 002 120 002 111 100 130 100 112 002 111 100 130 100 112 002 120 002 101 000
000 101 002 002 002 002 002 002 002 002 002 002 002 002 002 002 002 002 002 101 000
000 105 100 108 002 113 002 111 100 100 100 100 100 112 002 113 002 107 100 106 000
000 000 000 101 002 101 002 002 000 000 003 000 000 002 002 101 002 101 000 000 000
111 100 100 106 002 105 112 002 107 112 001 111 108 002 111 106 002 105 100 100 112
020 000 000 000 002 000 000 002 101 003 003 003 101 002 000 000 002 000 000 000 020
111 133 100 112 002 111 112 002 105 100 100 100 106 002 111 112 002 111 100 133 112
000 101 002 002 002 000 000 002 000 000 000 000 000 002 000 000 002 002 002 101 000
000 101 002 120 002 107 112 002 111 100 100 100 112 002 111 108 002 120 002 101 000 
000 101 002 002 002 101 002 002 000 000 003 000 000 002 002 101 002 002 002 101 000
000 105 133 112 002 110 002 111 100 100 133 100 100 112 002 110 002 111 133 106 000 
000 000 101 002 002 002 002 002 002 002 101 002 002 002 002 002 002 002 101 000 000 
000 000 101 002 111 112 002 111 108 002 101 002 107 112 002 111 112 002 101 000 000
107 100 106 002 002 002 002 002 101 002 101 002 101 002 002 002 002 002 105 100 108
101 002 002 002 111 100 112 002 110 002 110 002 110 002 111 100 112 002 002 002 101
101 003 120 002 002 002 002 002 002 002 002 002 002 002 002 002 002 002 120 003 101
101 002 002 002 107 100 100 100 100 108 000 107 100 100 100 100 108 002 002 002 101
105 100 100 100 106 000 000 000 000 110 021 110 000 000 000 000 105 100 100 100 106
# endleveldata