# lvlwidth 33
# lvlheight 23
# bgcolor 0 0 0
# edgecolour 85 0 100
# fillcolour 100 0 255
# pelletcolour 255 255 255
# fruittype 2

# startleveldata
000 100 021 100 000 000 000 000 000 000 000 000 000 000 000 100 021 100 000 000 000 000 000 000 000 000 000 000 000 100 021 100 000 
000 100 000 100 100 100 100 100 100 100 100 100 100 100 100 100 000 100 100 100 100 100 100 100 100 100 100 100 100 100 000 100 000 
000 100 002 002 002 002 002 002 002 002 100 002 002 002 002 002 002 002 002 002 002 002 100 002 002 002 002 002 002 002 002 100 000 
100 100 003 100 100 002 100 002 100 002 100 002 100 100 100 100 100 100 100 100 100 002 100 002 100 002 100 002 100 100 003 100 100 
020 000 002 002 002 002 100 002 100 000 000 002 002 002 002 002 100 002 002 002 002 002 000 000 100 002 100 002 002 002 002 000 020 
100 100 000 100 100 100 100 002 100 100 100 002 100 100 100 000 100 000 100 100 100 002 100 100 100 002 100 100 100 100 000 100 100 
000 100 002 002 002 002 002 002 002 002 002 002 000 000 100 000 100 000 100 000 000 002 002 002 002 002 002 002 002 002 002 100 000 
000 100 100 100 100 002 100 100 100 002 100 100 100 000 000 000 010 000 000 000 100 100 100 002 100 100 100 002 100 100 100 100 000 
000 100 002 002 002 002 002 002 100 002 100 000 000 000 100 100 001 100 100 000 000 000 100 002 100 002 002 002 002 002 002 100 000 
000 100 002 100 000 100 100 002 002 002 002 002 100 000 100 011 012 013 100 000 100 002 002 002 002 002 100 100 000 100 002 100 000 
000 100 002 002 002 002 002 002 100 000 100 100 100 002 100 100 100 100 100 002 100 100 100 000 100 002 002 002 002 002 002 100 000 
000 100 002 100 100 100 100 002 002 002 003 002 100 002 002 002 022 002 002 002 100 002 003 002 002 002 100 100 100 100 002 100 000
000 100 002 002 002 002 002 002 100 000 100 002 002 002 100 002 100 002 100 002 002 002 100 000 100 002 002 002 002 002 002 100 000 
000 100 002 100 100 000 100 002 100 000 100 002 100 100 100 002 100 002 100 100 100 002 100 000 100 002 100 000 100 100 002 100 000 
000 100 002 002 002 002 002 002 002 002 002 002 002 002 002 002 004 002 002 002 002 002 002 002 002 002 002 002 002 002 002 100 000 
000 100 100 100 002 100 100 000 100 100 100 100 100 000 100 100 100 100 100 000 100 100 100 100 100 000 100 100 002 100 100 100 000 
000 000 000 100 002 100 002 002 002 002 002 002 002 002 002 002 100 002 002 002 002 002 002 002 002 002 002 100 002 100 000 000 000 
100 100 100 100 002 100 002 100 002 100 100 100 100 100 100 002 100 002 100 100 100 100 100 100 002 100 002 100 002 100 100 100 100 
020 000 000 000 002 100 002 100 002 002 100 002 002 002 100 002 002 002 100 002 002 002 100 002 002 100 002 100 002 000 000 000 020 
100 100 000 100 003 100 002 100 100 002 100 002 100 002 100 002 100 002 100 002 100 002 100 002 100 100 002 100 003 100 000 100 100 
000 100 000 000 002 002 002 002 002 002 002 002 100 002 002 002 002 002 002 002 100 002 002 002 002 002 002 002 002 000 000 100 000 
000 100 000 100 100 100 100 100 100 100 100 100 100 100 100 100 000 100 100 100 100 100 100 100 100 100 100 100 100 100 000 100 000 
000 100 021 100 000 000 000 000 000 000 000 000 000 000 000 100 021 100 000 000 000 000 000 000 000 000 000 000 000 100 021 100 000 
# endleveldata

# corners
# ghost-blinky 2 2 5 4
# ghost-pinky 30 2 27 6
# ghost-inky 2 20 4 17
# ghost-clyde 30 20 27 17