# lvlwidth 21
# lvlheight 25
# bgcolour 0 0 0
# edgecolour 0 0 255
# fillcolour 0 0 0
# pelletcolour 255 255 255
# fruittype 1

# startleveldata
000 000 000 000 000 000 000 000 000 100 021 100 000 000 000 000 000 000 000 000 000
000 100 100 100 100 100 100 100 100 100 000 100 100 100 100 100 100 100 100 100 000
000 100 000 000 000 000 000 000 000 000 000 000 000 000 000 000 000 000 000 100 000
000 100 003 100 000 100 000 100 100 100 000 100 100 100 000 100 000 100 003 100 000
000 100 000 000 000 100 000 000 000 100 000 100 000 000 000 100 000 000 000 100 000
000 100 000 100 100 100 000 100 000 100 000 100 000 100 000 100 100 100 000 100 000
000 100 000 000 000 000 000 100 000 000 000 000 000 100 000 000 000 000 000 100 000
000 100 000 100 000 100 100 100 100 100 000 100 100 100 100 100 000 100 000 100 000
000 100 000 000 000 000 000 000 000 000 000 000 000 000 000 000 000 000 000 100 000
000 100 100 100 000 100 000 100 100 100 100 100 100 100 000 100 000 100 100 100 000
000 000 000 100 000 100 000 000 000 000 010 000 000 000 000 100 000 100 000 000 000
100 100 100 100 000 100 100 000 100 100 001 100 100 000 100 100 000 100 100 100 100
020 000 000 000 000 000 000 000 100 011 012 013 100 000 000 000 000 000 000 000 020
100 100 100 100 000 100 100 000 100 100 100 100 100 000 100 100 000 100 100 100 100
000 100 000 000 000 000 000 000 000 000 000 000 000 000 000 000 000 000 000 100 000
000 100 000 100 000 100 100 000 100 100 100 100 100 000 100 100 000 100 000 100 000 
000 100 000 000 000 100 000 000 000 000 004 000 000 000 000 100 000 000 000 100 000
000 100 100 100 000 100 000 100 100 100 100 100 100 100 000 100 000 100 100 100 000 
000 000 100 000 000 000 000 000 000 000 100 000 000 000 000 000 000 000 100 000 000 
000 000 100 000 100 100 000 100 100 000 100 000 100 100 000 100 100 000 100 000 000
100 100 100 000 000 000 000 000 100 000 100 000 100 000 000 000 000 000 100 100 100
100 000 000 000 100 100 100 000 100 000 100 000 100 000 100 100 100 000 000 000 100
100 003 100 000 000 000 000 000 000 000 000 000 000 000 000 000 000 000 100 003 100
100 000 000 000 100 100 100 100 100 100 000 100 100 100 100 100 100 000 000 000 100
100 100 100 100 100 000 000 000 000 100 021 100 000 000 000 000 100 100 100 100 100
# endleveldata