# lvlwidth 21
# lvlheight 25
# bgcolour 0 0 0
# edgecolour 0 0 255
# fillcolour 0 0 0
# pelletcolour 255 255 255
# fruittype 1

# startleveldata
000 000 000 000 000 000 000 000 000 100 021 100 000 000 000 000 000 000 000 000 000
000 100 100 100 100 100 100 100 100 100 000 100 100 100 100 100 100 100 100 100 000
000 100 002 000 000 000 000 000 000 000 000 000 000 000 000 000 000 000 000 100 000
000 100 000 100 000 100 000 100 100 100 000 100 100 100 000 100 000 100 000 100 000
000 100 000 000 000 100 000 000 000 100 000 100 000 000 000 100 000 000 000 100 000
000 100 000 100 100 100 000 100 000 100 000 100 000 100 000 100 100 100 000 100 000
000 100 000 000 000 000 000 100 000 000 000 000 000 100 000 000 000 000 000 100 000
000 100 000 100 000 100 100 100 100 100 000 100 100 100 100 100 000 100 000 100 000
000 100 000 000 000 000 000 000 000 000 000 000 000 000 000 000 000 000 000 100 000
000 100 100 100 000 100 000 100 100 100 100 100 100 100 000 100 000 100 100 100 000
000 000 000 100 000 100 000 000 000 000 000 000 000 000 000 100 000 100 000 000 000
100 100 100 100 000 100 100 000 100 100 001 100 100 000 100 100 000 100 100 100 100
020 010 000 003 004 000 000 000 100 011 012 013 100 000 000 000 000 000 000 000 020
100 100 100 100 000 100 100 000 100 100 100 100 100 000 100 100 000 100 100 100 100
000 100 000 000 000 000 000 000 000 000 022 000 000 000 000 000 000 000 000 100 000
000 100 000 100 000 100 100 000 100 100 100 100 100 000 100 100 000 100 000 100 000 
000 100 000 000 000 100 000 000 000 000 000 000 000 000 000 100 000 000 000 100 000
000 100 100 100 000 100 000 100 100 100 100 100 100 100 000 100 000 100 100 100 000 
000 000 100 000 000 000 000 000 000 000 100 000 000 000 000 000 000 000 100 000 000 
000 000 100 000 100 100 000 100 100 000 100 000 100 100 000 100 100 000 100 000 000
100 100 100 000 000 000 000 000 100 000 100 000 100 000 000 000 000 000 100 100 100
100 000 000 000 100 100 100 000 100 000 100 000 100 000 100 100 100 000 000 000 100
100 000 100 000 000 000 000 000 000 000 000 000 000 000 000 000 000 000 100 000 100
100 000 000 000 100 100 100 100 100 100 000 100 100 100 100 100 100 000 000 000 100
100 100 100 100 100 000 000 000 000 100 021 100 000 000 000 000 100 100 100 100 100
# endleveldata

# corners
# ghost-blinky 19 23 13 20
# ghost-pinky 19 23 13 20
# ghost-inky 19 23 13 20
# ghost-clyde 19 23 13 20