# lvlwidth 21
# lvlheight 25
# bgcolour 100 0 100
# edgecolour 0 0 255
# fillcolour 0 0 0
# pelletcolour 255 255 255
# fruittype 1

# startleveldata
000 000 000 000 000 000 000 000 000 113 021 113 000 000 000 000 000 000 000 000 000
000 107 100 100 100 100 100 100 100 106 000 105 100 100 100 100 100 100 100 108 000
000 101 000 000 000 000 000 000 000 000 000 000 000 000 000 000 000 000 000 101 000
000 101 003 120 000 113 000 111 100 108 000 107 100 112 000 113 000 120 003 101 000
000 101 000 000 000 101 000 000 000 101 000 101 000 000 000 101 000 000 000 101 000
000 101 000 111 100 106 000 113 000 110 000 110 000 113 000 105 100 112 000 101 000
000 101 000 000 000 000 000 101 000 000 000 000 000 101 000 000 000 000 000 101 000
000 101 000 120 000 111 100 130 100 112 000 111 100 130 100 112 000 120 000 101 000
000 101 000 000 000 000 000 000 000 000 000 000 000 000 000 000 000 000 000 101 000
000 105 100 108 000 113 000 111 100 100 100 100 100 112 000 113 000 107 100 106 000
000 000 000 101 000 101 000 000 000 000 003 000 000 000 000 101 000 101 000 000 000
111 100 100 106 000 105 112 000 107 112 001 111 108 000 111 106 000 105 100 100 112
020 000 000 000 000 000 000 000 101 003 003 003 101 000 000 000 000 000 000 000 020
111 133 100 112 000 111 112 000 105 100 100 100 106 000 111 112 000 111 100 133 112
000 101 000 000 000 000 000 000 000 000 000 000 000 000 000 000 000 000 000 101 000
000 101 000 120 000 107 112 000 111 100 100 100 112 000 111 108 000 120 000 101 000 
000 101 000 000 000 101 000 000 000 000 004 000 000 000 000 101 000 000 000 101 000
000 105 133 112 000 110 000 111 100 100 133 100 100 112 000 110 000 111 133 106 000 
000 000 101 000 000 000 000 000 000 000 101 000 000 000 000 000 000 000 101 000 000 
000 000 101 000 111 112 000 111 108 000 101 000 107 112 000 111 112 000 101 000 000
107 100 106 000 000 000 000 000 101 000 101 000 101 000 000 000 000 000 105 100 108
101 000 000 000 111 100 112 000 110 000 110 000 110 000 111 100 112 000 000 000 101
101 003 120 000 000 000 000 000 000 000 000 000 000 000 000 000 000 000 120 003 101
101 000 000 000 107 100 100 100 100 108 000 107 100 100 100 100 108 000 000 000 101
105 100 100 100 106 000 000 000 000 110 021 110 000 000 000 000 105 100 100 100 106
# endleveldata